NO ./textures/xpm/cyberpunk-north.xpm
SO ./textures/xpm/cyberpunk-south.xpm
WE ./textures/xpm/cyberpunk-west.xpm
EA ./textures/xpm/cyberpunk-east.xpm
F 85,24,96
C 161,203,192

          1111111
        11100000111
      111001010100111
     11000000000000011
    1100111010101110011
   110110000000000011011
  11000001111111110000011
 1101010110000000110101011
 1000000110011100110000001
110101000000101000000101011
100000011000101000110000001
101111111100101001111111101
1000000000000N0000000000001
101111111100101001111111101
100000011000101000110000001
110101000000101000000101011
 1000000110011100110000001
 1101010110000000110101011
  11000001111111110000011
   110110000000000011011
    1100111010101110011
     11000000000000011
      111001010100111
        11100000111
          1111111
