NO ./textures/xpm/cyberpunk-north.xpm
SO ./textures/xpm/cyberpunk-south.xpm
WE ./textures/xpm/cyberpunk-west.xpm
EA ./textures/xpm/cyberpunk-east.xpm
F 85,24,96
C 161,203,192

 1111111   11111   1111111
1       111     111       1
      111011111110111
     11000000000000011
    1100111010101110011
   110110000000000011011
  11000001110001110000011
 1101010110000000110101011
 1100000110000000110000011
111101000000000000000101111
1 10000110000000001100001 1
1 11111100001010000111111 1
  10000000000N00000000001
1 11111100001010000111111 1
1 10000110000000001100001 1
111101000000000000000101111
 1100000110000000110000011
 1101010110000000110101011
  11000001110001110000011
   110110000000000011011
    1100111010101110011
     11000000000000011
      111011111110111
1       111     111       1
 1111111   11111   1111111
