NO ./textures/BRICK_3D.xpm
SO ./textures/BRICK_3D.xpm
WE ./textures/BRICK_3B.xpm
EA ./textures/BRICK_3B.xpm
F 22,12,40
C 	239,203         	,1			

11111111111111111111111111111111111111

        1111111111111111111111111
        1000000000110000000000001
        1011000001110000000000001
        1001000000000000000000001
111111111011000001110000000000001
100000000011000001110111111111111
11110111111111011100001111111111111111111111
11110111111111011101011             1100011111
110000001101010111000E1              100010001
100000000000000011000011            11000111111
100000000000000011010101            1010001
1100000111010101111101111           1001111
11110111 1110101 101111011111111111111111111
11111111 1111111 111111111111
