SO ./path_to_the_south_texture
WE ./path_to_the_west_texture
EA ./path_to_the_east_texture
F 220,100,9
C 225,30,0
NO ./patje

11111111111111111111111111111111111111

        1111111111111111111111111
        1000000000110000000000001
        1011000001110000000000001
        1001000000000000000000001
111111111011000001110000000000001
100000000011000001110111111111111
11110111111111011100001111111111111111111111
11110111111111011101011             1100011111
110000001101010111000N1              100010001
100000000000000011000011            11000111111
100000000000000011010101            1010001
1100000111010101111101111           1001111
11110111 1110101 101111011111111111111111111
11111111 1111111 111111111111