NO ./textures/xpm/watertemple-north.xpm
SO ./textures/xpm/watertemple-south.xpm
WE ./textures/xpm/watertemple-west.xpm
EA ./textures/xpm/watertemple-east.xpm
F 83,139,118
C 194,230,156
11111
10001
10N01
10001
11111
