 NO ./minilibx-linux/test/open.xpm
 SO ./minilibx-linux/test/open.xpm
 WE ./minilibx-linux/test/open.xpm
 EA ./minilibx-linux/test/open.xpm
 F 120,80,30
 1111111
 1     1
 1  N  1
 1     1
 1111111
