 NO ./minilibx-linux/test/open.xpm
 SO ./minilibx-linux/test/open.xpm
 WE ./minilibx-linux/test/open.xpm
 EA ./minilibx-linux/test/open.xpm
 F 120,80,30
 C 50,100,180
111111
100101
101001
1100N1
111111
