NO ./textures/xpm/watertemple-north.xpm
SO ./textures/xpm/watertemple-south.xpm
WE ./textures/xpm/watertemple-west.xpm
EA ./textures/xpm/watertemple-east.xpm
F 83,139,118
C 194,230,156

        11111       11111
      111000111   111000111
     11000100011 11000100011
    1100100010011100100010011
    1000001000001000001000001
    1010100010100010100010101
    1100001000000000001000011
     11010001111011110001011
      100011000000000110001
    111100100111111001001111
  1110000000110000110000000111
 110001010101001100101010100011
11001000000000111100000000010011
10000010010011111111001001000001
10101000111011000011011100010101
10000010010011111111001001000001
11001000000000111100000000010011
 110001010101001100101010100011
  1110000000110000110000000111
    111100100111111001001111
      110011000000001100111
     11010001111011110001011
    1100001000000000001000011
    101010001010N010100010101
    1000001000001000001000001
    1100100010011100100010011
     11000100011 11000100011
      111000111   111000111
        11111       11111
