NO ./textures/xpm/watertemple-north.xpm
SO ./textures/xpm/watertemple-south.xpm
WE ./textures/xpm/watertemple-west.xpm
EA ./textures/xpm/watertemple-east.xpm
F 83,139,118
C 194,230,156

11      11111111111111111     11
1     111000111   111000111    1
     11000100011 11000100011
    1100100010011100100010011
    1000001000001000001000001
    1010100010100010100010101
    1100001000000000001000011
     11010001111011110001011
      100011000000000110001
    111100100111111001001111
1 11100000001100001100000001111 1
111000101010100000001010101000111
110010000000000010000000000010011
100000100000011111110000001000001
10101000000001     10000000010101
100000100000011111110000001000001
110010000000000010000000000010011
111000101000100000001000101000111
1 11100000000000000000000001111 1
    111100100000000001001111
      110011000000001100111
     11010000000000000001011
    1100001000000000001000011
    101010001010N010100010101
    1000001000001000001000001
    1100100010011100100010011
     11000100011 11000100011
1     111000111   111000111    1
11      11111111111111111     11
